а -> (пробел)
б -> а
в -> б
г -> в
д -> г
е -> д
ж -> е
з -> ж
и -> з
й -> и
к -> й
л -> к
м -> л
н -> м
о -> н
п -> о
р -> п
с -> р
т -> с
у -> т
ф -> у
х -> ф
ц -> х
ч -> ц
ш -> ч
щ -> ш
ъ -> щ
ы -> ъ
ь -> ы
э -> ь
ю -> э
я -> ю
(пробел) -> я