7 -> (пробел)
О -> о
У -> и
8 -> е
c -> т
r -> н
Л -> с
Б -> а
Ч -> к
Х -> я
Д -> р
М -> м
t -> л
b -> п
А -> в
< -> д
Р -> ь
Е -> у
5 -> ч
1 -> й
К -> з
4 -> ж
(пробел) -> э
> -> ы
? -> г
2 -> ц
Ф -> ,
И -> ф
П -> б
Й -> ю
a -> х
Ь -> щ
Ы -> ш